STATE/UT,YEAR,GENDER,Upto 10 years,10-15 years,15-18 years,18-30 years,30-50 years,Above 50 years,Total
A&N ISLANDS,2001,Female,0,0,0,4,2,0,6
A&N ISLANDS,2001,Male,0,1,0,3,3,0,7
A&N ISLANDS,2001,Total,0,1,0,7,5,0,13
A&N ISLANDS,2002,Female,0,0,1,2,4,0,7
A&N ISLANDS,2002,Male,0,0,0,4,4,2,10
A&N ISLANDS,2002,Total,0,0,1,6,8,2,17
A&N ISLANDS,2003,Female,1,0,0,2,5,1,9
A&N ISLANDS,2003,Male,0,0,0,6,5,1,12
A&N ISLANDS,2003,Total,1,0,0,8,10,2,21
A&N ISLANDS,2004,Female,0,0,0,0,5,0,5
A&N ISLANDS,2004,Male,1,0,0,2,5,2,10
A&N ISLANDS,2004,Total,1,0,0,2,10,2,15
A&N ISLANDS,2005,Female,0,0,0,1,3,0,4
A&N ISLANDS,2005,Male,1,0,0,4,5,1,11
A&N ISLANDS,2005,Total,1,0,0,5,8,1,15
A&N ISLANDS,2006,Female,0,0,0,0,1,0,1
A&N ISLANDS,2006,Male,0,0,0,1,1,2,4
A&N ISLANDS,2006,Total,0,0,0,1,2,2,5
A&N ISLANDS,2007,Female,0,0,0,3,2,1,6
A&N ISLANDS,2007,Male,0,0,0,3,4,2,9
A&N ISLANDS,2007,Total,0,0,0,6,6,3,15
A&N ISLANDS,2008,Female,0,2,0,0,0,0,2
A&N ISLANDS,2008,Male,0,0,0,2,2,2,6
A&N ISLANDS,2008,Total,0,2,0,2,2,2,8
A&N ISLANDS,2009,Female,1,0,0,3,4,0,8
A&N ISLANDS,2009,Male,2,0,0,3,5,0,10
A&N ISLANDS,2009,Total,3,0,0,6,9,0,18
A&N ISLANDS,2010,Female,0,0,2,0,3,0,5
A&N ISLANDS,2010,Male,0,0,0,2,3,0,5
A&N ISLANDS,2010,Total,0,0,2,2,6,0,10
A&N ISLANDS,2011,Female,0,0,0,5,3,1,9
A&N ISLANDS,2011,Male,0,1,0,1,2,2,6
A&N ISLANDS,2011,Total,0,1,0,6,5,3,15
A&N ISLANDS,2012,Female,1,0,0,3,2,1,7
A&N ISLANDS,2012,Male,1,0,0,3,4,2,10
A&N ISLANDS,2012,Total,2,0,0,6,6,3,17
A&N ISLANDS,2013,Female,0,0,0,0,2,0,2
A&N ISLANDS,2013,Male,0,0,0,2,2,0,4
A&N ISLANDS,2013,Total,0,0,0,2,4,0,6
ANDHRA PRADESH,2001,Female,38,15,43,269,175,67,607
ANDHRA PRADESH,2001,Male,35,59,88,827,952,215,2176
ANDHRA PRADESH,2001,Total,73,74,131,1096,1127,282,2783
ANDHRA PRADESH,2002,Female,5,17,3,371,185,81,662
ANDHRA PRADESH,2002,Male,7,3,10,949,826,194,1989
ANDHRA PRADESH,2002,Total,12,20,13,1320,1011,275,2651
ANDHRA PRADESH,2003,Female,8,8,12,378,257,74,737
ANDHRA PRADESH,2003,Male,17,31,43,992,887,207,2177
ANDHRA PRADESH,2003,Total,25,39,55,1370,1144,281,2914
ANDHRA PRADESH,2004,Female,13,10,14,301,254,63,655
ANDHRA PRADESH,2004,Male,22,15,15,856,855,222,1985
ANDHRA PRADESH,2004,Total,35,25,29,1157,1109,285,2640
ANDHRA PRADESH,2005,Female,14,7,7,324,302,68,722
ANDHRA PRADESH,2005,Male,24,14,21,953,949,245,2206
ANDHRA PRADESH,2005,Total,38,21,28,1277,1251,313,2928
ANDHRA PRADESH,2006,Female,16,9,11,322,306,80,744
ANDHRA PRADESH,2006,Male,12,11,4,1045,812,312,2196
ANDHRA PRADESH,2006,Total,28,20,15,1367,1118,392,2940
ANDHRA PRADESH,2007,Female,26,16,10,415,352,67,886
ANDHRA PRADESH,2007,Male,19,8,29,874,828,206,1964
ANDHRA PRADESH,2007,Total,45,24,39,1289,1180,273,2850
ANDHRA PRADESH,2008,Female,25,7,9,411,296,82,830
ANDHRA PRADESH,2008,Male,11,14,55,855,776,221,1932
ANDHRA PRADESH,2008,Total,36,21,64,1266,1072,303,2762
ANDHRA PRADESH,2009,Female,18,6,7,379,299,91,800
ANDHRA PRADESH,2009,Male,12,12,22,668,777,184,1675
ANDHRA PRADESH,2009,Total,30,18,29,1047,1076,275,2475
ANDHRA PRADESH,2010,Female,15,12,6,235,213,143,624
ANDHRA PRADESH,2010,Male,7,16,13,962,591,325,1914
ANDHRA PRADESH,2010,Total,22,28,19,1197,804,468,2538
ANDHRA PRADESH,2011,Female,21,9,24,434,369,116,973
ANDHRA PRADESH,2011,Male,35,5,7,583,934,271,1835
ANDHRA PRADESH,2011,Total,56,14,31,1017,1303,387,2808
ANDHRA PRADESH,2012,Female,40,12,16,419,476,116,1079
ANDHRA PRADESH,2012,Male,18,10,22,519,830,247,1646
ANDHRA PRADESH,2012,Total,58,22,38,938,1306,363,2725
ANDHRA PRADESH,2013,Female,20,9,11,287,300,123,750
ANDHRA PRADESH,2013,Male,26,9,19,445,1036,199,1734
ANDHRA PRADESH,2013,Total,46,18,30,732,1336,322,2484
ARUNACHAL PRADESH,2001,Female,0,0,0,10,4,2,16
ARUNACHAL PRADESH,2001,Male,0,0,0,31,32,4,67
ARUNACHAL PRADESH,2001,Total,0,0,0,41,36,6,83
ARUNACHAL PRADESH,2002,Female,0,0,0,3,1,0,4
ARUNACHAL PRADESH,2002,Male,0,0,0,31,26,0,57
ARUNACHAL PRADESH,2002,Total,0,0,0,34,27,0,61
ARUNACHAL PRADESH,2003,Female,0,0,0,0,0,0,0
ARUNACHAL PRADESH,2003,Male,0,0,0,64,13,0,77
ARUNACHAL PRADESH,2003,Total,0,0,0,64,13,0,77
ARUNACHAL PRADESH,2004,Female,0,0,0,0,2,0,2
ARUNACHAL PRADESH,2004,Male,0,0,0,36,26,3,65
ARUNACHAL PRADESH,2004,Total,0,0,0,36,28,3,67
ARUNACHAL PRADESH,2005,Female,0,0,0,1,0,0,1
ARUNACHAL PRADESH,2005,Male,0,0,0,58,20,2,80
ARUNACHAL PRADESH,2005,Total,0,0,0,59,20,2,81
ARUNACHAL PRADESH,2006,Female,0,0,0,0,0,0,0
ARUNACHAL PRADESH,2006,Male,0,0,0,40,20,0,60
ARUNACHAL PRADESH,2006,Total,0,0,0,40,20,0,60
ARUNACHAL PRADESH,2007,Female,0,0,0,3,0,0,3
ARUNACHAL PRADESH,2007,Male,0,0,0,41,23,1,65
ARUNACHAL PRADESH,2007,Total,0,0,0,44,23,1,68
ARUNACHAL PRADESH,2008,Female,0,0,0,0,1,0,1
ARUNACHAL PRADESH,2008,Male,0,0,0,40,29,2,71
ARUNACHAL PRADESH,2008,Total,0,0,0,40,30,2,72
ARUNACHAL PRADESH,2009,Female,0,0,0,1,0,0,1
ARUNACHAL PRADESH,2009,Male,0,0,0,30,28,0,58
ARUNACHAL PRADESH,2009,Total,0,0,0,31,28,0,59
ARUNACHAL PRADESH,2010,Female,0,0,0,2,0,0,2
ARUNACHAL PRADESH,2010,Male,0,0,0,53,20,0,73
ARUNACHAL PRADESH,2010,Total,0,0,0,55,20,0,75
ARUNACHAL PRADESH,2011,Female,0,0,0,4,1,0,5
ARUNACHAL PRADESH,2011,Male,0,0,0,38,21,1,60
ARUNACHAL PRADESH,2011,Total,0,0,0,42,22,1,65
ARUNACHAL PRADESH,2012,Female,0,0,0,7,3,0,10
ARUNACHAL PRADESH,2012,Male,0,0,0,42,21,0,63
ARUNACHAL PRADESH,2012,Total,0,0,0,49,24,0,73
ARUNACHAL PRADESH,2013,Female,0,1,1,2,0,0,4
ARUNACHAL PRADESH,2013,Male,0,0,1,32,31,1,65
ARUNACHAL PRADESH,2013,Total,0,1,2,34,31,1,69
ASSAM,2001,Female,4,8,23,45,37,11,128
ASSAM,2001,Male,17,30,169,577,368,67,1228
ASSAM,2001,Total,21,38,192,622,405,78,1356
ASSAM,2002,Female,0,0,0,64,43,4,111
ASSAM,2002,Male,2,0,0,763,356,21,1142
ASSAM,2002,Total,2,0,0,827,399,25,1253
ASSAM,2003,Female,0,0,0,68,31,4,103
ASSAM,2003,Male,2,0,0,571,460,55,1088
ASSAM,2003,Total,2,0,0,639,491,59,1191
ASSAM,2004,Female,0,0,0,55,25,4,84
ASSAM,2004,Male,1,0,0,636,425,68,1130
ASSAM,2004,Total,1,0,0,691,450,72,1214
ASSAM,2005,Female,0,0,0,42,19,4,65
ASSAM,2005,Male,0,4,9,672,372,72,1129
ASSAM,2005,Total,0,4,9,714,391,76,1194
ASSAM,2006,Female,0,0,0,43,31,2,76
ASSAM,2006,Male,0,4,7,648,391,81,1131
ASSAM,2006,Total,0,4,7,691,422,83,1207
ASSAM,2007,Female,0,0,0,51,37,0,88
ASSAM,2007,Male,0,1,1,766,421,97,1286
ASSAM,2007,Total,0,1,1,817,458,97,1374
ASSAM,2008,Female,0,0,0,61,42,0,103
ASSAM,2008,Male,0,1,0,790,477,55,1323
ASSAM,2008,Total,0,1,0,851,519,55,1426
ASSAM,2009,Female,0,0,0,62,35,0,97
ASSAM,2009,Male,0,0,4,784,398,40,1226
ASSAM,2009,Total,0,0,4,846,433,40,1323
ASSAM,2010,Female,0,0,0,51,35,0,86
ASSAM,2010,Male,0,0,10,712,369,46,1137
ASSAM,2010,Total,0,0,10,763,404,46,1223
ASSAM,2011,Female,0,0,0,64,31,0,95
ASSAM,2011,Male,0,0,8,741,411,48,1208
ASSAM,2011,Total,0,0,8,805,442,48,1303
ASSAM,2012,Female,0,0,0,56,21,0,77
ASSAM,2012,Male,0,0,15,736,489,51,1291
ASSAM,2012,Total,0,0,15,792,510,51,1368
ASSAM,2013,Female,0,0,0,68,29,0,97
ASSAM,2013,Male,0,3,11,827,370,46,1257
ASSAM,2013,Total,0,3,11,895,399,46,1354
BIHAR,2001,Female,0,0,40,191,123,12,366
BIHAR,2001,Male,2,2,156,1484,1406,227,3277
BIHAR,2001,Total,2,2,196,1675,1529,239,3643
BIHAR,2002,Female,3,0,2,242,144,6,397
BIHAR,2002,Male,4,3,3,1874,1395,155,3434
BIHAR,2002,Total,7,3,5,2116,1539,161,3831
BIHAR,2003,Female,3,0,2,235,147,6,393
BIHAR,2003,Male,2,2,3,1637,1536,199,3379
BIHAR,2003,Total,5,2,5,1872,1683,205,3772
BIHAR,2004,Female,2,4,0,269,140,10,425
BIHAR,2004,Male,2,9,4,1906,1424,178,3523
BIHAR,2004,Total,4,13,4,2175,1564,188,3948
BIHAR,2005,Female,9,2,3,310,102,16,442
BIHAR,2005,Male,5,8,10,1850,983,173,3029
BIHAR,2005,Total,14,10,13,2160,1085,189,3471
BIHAR,2006,Female,2,1,2,282,118,8,413
BIHAR,2006,Male,1,1,5,1651,1075,103,2836
BIHAR,2006,Total,3,2,7,1933,1193,111,3249
BIHAR,2007,Female,4,0,15,237,120,14,390
BIHAR,2007,Male,12,23,41,1451,1012,152,2691
BIHAR,2007,Total,16,23,56,1688,1132,166,3081
BIHAR,2008,Female,12,8,12,436,151,18,637
BIHAR,2008,Male,25,11,48,1401,921,96,2502
BIHAR,2008,Total,37,19,60,1837,1072,114,3139
BIHAR,2009,Female,9,5,27,439,174,18,672
BIHAR,2009,Male,13,21,51,1419,878,125,2507
BIHAR,2009,Total,22,26,78,1858,1052,143,3179
BIHAR,2010,Female,10,14,50,370,187,31,662
BIHAR,2010,Male,16,30,82,1491,887,194,2700
BIHAR,2010,Total,26,44,132,1861,1074,225,3362
BIHAR,2011,Female,10,9,21,390,157,17,604
BIHAR,2011,Male,18,26,40,1322,1033,155,2594
BIHAR,2011,Total,28,35,61,1712,1190,172,3198
BIHAR,2012,Female,12,15,33,486,213,27,786
BIHAR,2012,Male,11,17,47,1509,1059,175,2818
BIHAR,2012,Total,23,32,80,1995,1272,202,3604
BIHAR,2013,Female,15,12,34,446,184,17,708
BIHAR,2013,Male,29,24,72,1428,1047,133,2733
BIHAR,2013,Total,44,36,106,1874,1231,150,3441
CHANDIGARH,2001,Female,0,0,0,1,1,3,5
CHANDIGARH,2001,Male,0,0,0,4,5,1,10
CHANDIGARH,2001,Total,0,0,0,5,6,4,15
CHANDIGARH,2002,Female,1,0,0,3,3,2,9
CHANDIGARH,2002,Male,2,0,0,9,10,1,22
CHANDIGARH,2002,Total,3,0,0,12,13,3,31
CHANDIGARH,2003,Female,1,1,0,3,0,1,6
CHANDIGARH,2003,Male,0,1,0,5,9,0,15
CHANDIGARH,2003,Total,1,2,0,8,9,1,21
CHANDIGARH,2004,Female,2,0,0,3,3,0,8
CHANDIGARH,2004,Male,0,0,1,5,6,2,14
CHANDIGARH,2004,Total,2,0,1,8,9,2,22
CHANDIGARH,2005,Female,1,0,0,1,0,1,3
CHANDIGARH,2005,Male,2,0,0,6,7,0,15
CHANDIGARH,2005,Total,3,0,0,7,7,1,18
CHANDIGARH,2006,Female,0,0,0,0,1,3,4
CHANDIGARH,2006,Male,1,0,0,2,5,2,10
CHANDIGARH,2006,Total,1,0,0,2,6,5,14
CHANDIGARH,2007,Female,2,0,0,3,0,1,6
CHANDIGARH,2007,Male,0,0,0,7,7,0,14
CHANDIGARH,2007,Total,2,0,0,10,7,1,20
CHANDIGARH,2008,Female,0,0,0,3,2,1,6
CHANDIGARH,2008,Male,0,0,0,7,3,1,11
CHANDIGARH,2008,Total,0,0,0,10,5,2,17
CHANDIGARH,2009,Female,0,0,0,1,2,0,3
CHANDIGARH,2009,Male,1,0,0,11,6,1,19
CHANDIGARH,2009,Total,1,0,0,12,8,1,22
CHANDIGARH,2010,Female,0,0,0,1,0,1,2
CHANDIGARH,2010,Male,1,0,0,5,11,3,20
CHANDIGARH,2010,Total,1,0,0,6,11,4,22
CHANDIGARH,2011,Female,0,0,2,1,2,0,5
CHANDIGARH,2011,Male,0,0,1,11,7,1,20
CHANDIGARH,2011,Total,0,0,3,12,9,1,25
CHANDIGARH,2012,Female,0,0,1,0,5,0,6
CHANDIGARH,2012,Male,1,0,1,9,3,1,15
CHANDIGARH,2012,Total,1,0,2,9,8,1,21
CHANDIGARH,2013,Female,2,0,0,0,0,0,2
CHANDIGARH,2013,Male,0,0,9,10,1,0,20
CHANDIGARH,2013,Total,2,0,9,10,1,0,22
CHHATTISGARH,2001,Female,38,14,38,214,182,63,549
CHHATTISGARH,2001,Male,30,12,30,341,553,142,1108
CHHATTISGARH,2001,Total,68,26,68,555,735,205,1657
CHHATTISGARH,2002,Female,5,2,2,111,82,26,228
CHHATTISGARH,2002,Male,19,5,2,153,357,80,616
CHHATTISGARH,2002,Total,24,7,4,264,439,106,844
CHHATTISGARH,2003,Female,9,4,1,84,88,30,216
CHHATTISGARH,2003,Male,16,8,2,228,262,65,581
CHHATTISGARH,2003,Total,25,12,3,312,350,95,797
CHHATTISGARH,2004,Female,5,5,7,96,124,32,269
CHHATTISGARH,2004,Male,15,6,23,235,288,91,658
CHHATTISGARH,2004,Total,20,11,30,331,412,123,927
CHHATTISGARH,2005,Female,4,6,5,125,148,35,323
CHHATTISGARH,2005,Male,7,8,7,280,337,88,727
CHHATTISGARH,2005,Total,11,14,12,405,485,123,1050
CHHATTISGARH,2006,Female,4,7,10,159,116,40,336
CHHATTISGARH,2006,Male,8,5,14,268,366,101,762
CHHATTISGARH,2006,Total,12,12,24,427,482,141,1098
CHHATTISGARH,2007,Female,3,4,3,100,129,71,310
CHHATTISGARH,2007,Male,10,11,14,281,315,156,787
CHHATTISGARH,2007,Total,13,15,17,381,444,227,1097
CHHATTISGARH,2008,Female,10,7,27,129,150,40,363
CHHATTISGARH,2008,Male,13,12,29,282,358,112,806
CHHATTISGARH,2008,Total,23,19,56,411,508,152,1169
CHHATTISGARH,2009,Female,15,2,7,124,134,44,326
CHHATTISGARH,2009,Male,24,9,27,231,349,117,757
CHHATTISGARH,2009,Total,39,11,34,355,483,161,1083
CHHATTISGARH,2010,Female,13,5,19,127,153,40,357
CHHATTISGARH,2010,Male,19,8,31,231,314,105,708
CHHATTISGARH,2010,Total,32,13,50,358,467,145,1065
CHHATTISGARH,2011,Female,12,7,11,126,135,67,358
CHHATTISGARH,2011,Male,16,14,16,249,329,128,752
CHHATTISGARH,2011,Total,28,21,27,375,464,195,1110
CHHATTISGARH,2012,Female,11,14,12,120,113,46,316
CHHATTISGARH,2012,Male,15,15,20,202,318,113,683
CHHATTISGARH,2012,Total,26,29,32,322,431,159,999
CHHATTISGARH,2013,Female,14,4,13,113,138,62,344
CHHATTISGARH,2013,Male,31,16,33,176,262,112,630
CHHATTISGARH,2013,Total,45,20,46,289,400,174,974
D&N HAVELI,2001,Female,0,0,0,0,0,0,0
D&N HAVELI,2001,Male,0,0,0,1,2,0,3
D&N HAVELI,2001,Total,0,0,0,1,2,0,3
D&N HAVELI,2002,Female,0,0,0,0,1,0,1
D&N HAVELI,2002,Male,0,0,0,2,7,1,10
D&N HAVELI,2002,Total,0,0,0,2,8,1,11
D&N HAVELI,2003,Female,0,0,0,1,1,1,3
D&N HAVELI,2003,Male,0,0,0,3,4,1,8
D&N HAVELI,2003,Total,0,0,0,4,5,2,11
D&N HAVELI,2004,Female,2,0,0,0,0,0,2
D&N HAVELI,2004,Male,0,0,1,3,4,1,9
D&N HAVELI,2004,Total,2,0,1,3,4,1,11
D&N HAVELI,2005,Female,0,0,0,0,0,0,0
D&N HAVELI,2005,Male,1,0,1,2,1,2,7
D&N HAVELI,2005,Total,1,0,1,2,1,2,7
D&N HAVELI,2006,Female,0,0,0,2,1,0,3
D&N HAVELI,2006,Male,1,0,0,1,3,1,6
D&N HAVELI,2006,Total,1,0,0,3,4,1,9
D&N HAVELI,2007,Female,0,0,0,2,2,0,4
D&N HAVELI,2007,Male,1,0,0,1,4,0,6
D&N HAVELI,2007,Total,1,0,0,3,6,0,10
D&N HAVELI,2008,Female,0,1,0,0,2,1,4
D&N HAVELI,2008,Male,0,0,0,0,3,2,5
D&N HAVELI,2008,Total,0,1,0,0,5,3,9
D&N HAVELI,2009,Female,0,0,0,3,3,0,6
D&N HAVELI,2009,Male,1,0,0,1,1,1,4
D&N HAVELI,2009,Total,1,0,0,4,4,1,10
D&N HAVELI,2010,Female,0,0,0,1,0,0,1
D&N HAVELI,2010,Male,0,0,0,0,5,0,5
D&N HAVELI,2010,Total,0,0,0,1,5,0,6
D&N HAVELI,2011,Female,0,0,0,2,0,0,2
D&N HAVELI,2011,Male,1,0,1,6,3,1,12
D&N HAVELI,2011,Total,1,0,1,8,3,1,14
D&N HAVELI,2012,Female,0,0,0,1,1,0,2
D&N HAVELI,2012,Male,0,1,0,3,1,0,5
D&N HAVELI,2012,Total,0,1,0,4,2,0,7
D&N HAVELI,2013,Female,0,0,0,0,0,1,1
D&N HAVELI,2013,Male,0,0,0,0,1,1,2
D&N HAVELI,2013,Total,0,0,0,0,1,2,3
DAMAN & DIU,2002,Female,0,0,0,2,0,0,2
DAMAN & DIU,2002,Male,0,0,0,3,3,0,6
DAMAN & DIU,2002,Total,0,0,0,5,3,0,8
DAMAN & DIU,2003,Female,0,0,0,0,0,0,0
DAMAN & DIU,2003,Male,0,0,0,0,3,3,6
DAMAN & DIU,2003,Total,0,0,0,0,3,3,6
DAMAN & DIU,2004,Female,0,0,0,1,0,0,1
DAMAN & DIU,2004,Male,0,0,0,1,1,0,2
DAMAN & DIU,2004,Total,0,0,0,2,1,0,3
DAMAN & DIU,2005,Female,0,0,0,0,0,0,0
DAMAN & DIU,2005,Male,0,1,0,4,0,0,5
DAMAN & DIU,2005,Total,0,1,0,4,0,0,5
DAMAN & DIU,2006,Female,2,0,0,0,0,0,2
DAMAN & DIU,2006,Male,0,0,0,3,2,0,5
DAMAN & DIU,2006,Total,2,0,0,3,2,0,7
DAMAN & DIU,2007,Female,0,0,0,1,0,0,1
DAMAN & DIU,2007,Male,1,1,0,3,2,4,11
DAMAN & DIU,2007,Total,1,1,0,4,2,4,12
DAMAN & DIU,2008,Female,0,0,0,0,0,0,0
DAMAN & DIU,2008,Male,0,0,0,0,2,0,2
DAMAN & DIU,2008,Total,0,0,0,0,2,0,2
DAMAN & DIU,2009,Female,0,0,0,1,0,0,1
DAMAN & DIU,2009,Male,0,0,0,1,3,0,4
DAMAN & DIU,2009,Total,0,0,0,2,3,0,5
DAMAN & DIU,2010,Female,0,0,0,0,0,0,0
DAMAN & DIU,2010,Male,0,0,0,4,1,0,5
DAMAN & DIU,2010,Total,0,0,0,4,1,0,5
DAMAN & DIU,2011,Female,0,0,0,1,0,3,4
DAMAN & DIU,2011,Male,0,0,0,1,1,0,2
DAMAN & DIU,2011,Total,0,0,0,2,1,3,6
DAMAN & DIU,2012,Female,0,0,0,1,0,0,1
DAMAN & DIU,2012,Male,1,0,0,1,1,0,3
DAMAN & DIU,2012,Total,1,0,0,2,1,0,4
DAMAN & DIU,2013,Female,0,0,0,2,2,0,4
DAMAN & DIU,2013,Male,1,0,0,3,1,0,5
DAMAN & DIU,2013,Total,1,0,0,5,3,0,9
DELHI UT,2001,Female,12,2,9,74,41,14,152
DELHI UT,2001,Male,13,10,12,231,128,28,422
DELHI UT,2001,Total,25,12,21,305,169,42,574
DELHI UT,2002,Female,6,3,2,69,36,14,130
DELHI UT,2002,Male,8,8,8,243,118,26,411
DELHI UT,2002,Total,14,11,10,312,154,40,541
DELHI UT,2003,Female,8,6,7,44,43,23,131
DELHI UT,2003,Male,11,10,12,210,103,25,371
DELHI UT,2003,Total,19,16,19,254,146,48,502
DELHI UT,2004,Female,14,7,7,51,30,16,125
DELHI UT,2004,Male,20,14,15,170,134,32,385
DELHI UT,2004,Total,34,21,22,221,164,48,510
DELHI UT,2005,Female,7,3,3,87,43,15,158
DELHI UT,2005,Male,10,9,4,197,130,25,375
DELHI UT,2005,Total,17,12,7,284,173,40,533
DELHI UT,2006,Female,12,2,8,75,23,8,128
DELHI UT,2006,Male,18,10,16,208,88,20,360
DELHI UT,2006,Total,30,12,24,283,111,28,488
DELHI UT,2007,Female,10,3,5,71,25,13,127
DELHI UT,2007,Male,14,5,20,205,112,28,384
DELHI UT,2007,Total,24,8,25,276,137,41,511
DELHI UT,2008,Female,4,1,2,63,39,7,116
DELHI UT,2008,Male,21,8,15,139,254,36,473
DELHI UT,2008,Total,25,9,17,202,293,43,589
DELHI UT,2009,Female,13,4,2,48,41,18,126
DELHI UT,2009,Male,17,17,28,243,117,23,445
DELHI UT,2009,Total,30,21,30,291,158,41,571
DELHI UT,2010,Female,4,3,4,55,39,14,119
DELHI UT,2010,Male,6,8,14,238,167,25,458
DELHI UT,2010,Total,10,11,18,293,206,39,577
DELHI UT,2011,Female,11,1,14,69,28,15,138
DELHI UT,2011,Male,12,11,16,212,160,20,431
DELHI UT,2011,Total,23,12,30,281,188,35,569
DELHI UT,2012,Female,6,1,8,68,32,16,131
DELHI UT,2012,Male,10,6,14,195,152,32,409
DELHI UT,2012,Total,16,7,22,263,184,48,540
DELHI UT,2013,Female,5,1,8,51,50,7,122
DELHI UT,2013,Male,15,7,13,223,112,38,408
DELHI UT,2013,Total,20,8,21,274,162,45,530
GOA,2001,Female,0,0,0,4,8,1,13
GOA,2001,Male,1,0,0,11,10,2,24
GOA,2001,Total,1,0,0,15,18,3,37
GOA,2002,Female,0,0,0,1,2,4,7
GOA,2002,Male,1,0,1,9,7,6,24
GOA,2002,Total,1,0,1,10,9,10,31
GOA,2003,Female,0,0,0,5,5,4,14
GOA,2003,Male,0,0,0,6,12,2,20
GOA,2003,Total,0,0,0,11,17,6,34
GOA,2004,Female,0,1,0,7,4,5,17
GOA,2004,Male,1,0,0,8,13,3,25
GOA,2004,Total,1,1,0,15,17,8,42
GOA,2005,Female,3,0,0,7,3,1,14
GOA,2005,Male,0,1,0,7,23,4,35
GOA,2005,Total,3,1,0,14,26,5,49
GOA,2006,Female,0,0,1,4,2,3,10
GOA,2006,Male,0,0,1,8,13,8,30
GOA,2006,Total,0,0,2,12,15,11,40
GOA,2007,Female,2,0,0,6,4,4,16
GOA,2007,Male,0,0,0,3,11,4,18
GOA,2007,Total,2,0,0,9,15,8,34
GOA,2008,Female,2,1,0,8,4,5,20
GOA,2008,Male,0,0,0,10,17,6,33
GOA,2008,Total,2,1,0,18,21,11,53
GOA,2009,Female,1,0,1,14,12,3,31
GOA,2009,Male,2,0,0,8,13,3,26
GOA,2009,Total,3,0,1,22,25,6,57
GOA,2010,Female,0,0,1,5,1,0,7
GOA,2010,Male,0,0,0,9,17,2,28
GOA,2010,Total,0,0,1,14,18,2,35
GOA,2011,Female,1,0,0,6,3,1,11
GOA,2011,Male,0,1,0,15,17,5,38
GOA,2011,Total,1,1,0,21,20,6,49
GOA,2012,Female,0,1,0,4,9,4,18
GOA,2012,Male,2,0,0,9,9,9,29
GOA,2012,Total,2,1,0,13,18,13,47
GOA,2013,Female,0,0,0,5,4,3,12
GOA,2013,Male,0,0,0,11,8,6,25
GOA,2013,Total,0,0,0,16,12,9,37
GUJARAT,2001,Female,57,9,8,132,131,26,363
GUJARAT,2001,Male,50,11,18,335,416,87,917
GUJARAT,2001,Total,107,20,26,467,547,113,1280
GUJARAT,2002,Female,57,25,11,252,182,67,594
GUJARAT,2002,Male,72,16,31,723,702,189,1733
GUJARAT,2002,Total,129,41,42,975,884,256,2327
GUJARAT,2003,Female,29,1,3,160,130,33,356
GUJARAT,2003,Male,32,5,13,297,379,82,808
GUJARAT,2003,Total,61,6,16,457,509,115,1164
GUJARAT,2004,Female,53,2,6,157,97,25,340
GUJARAT,2004,Male,31,5,6,315,393,79,829
GUJARAT,2004,Total,84,7,12,472,490,104,1169
GUJARAT,2005,Female,29,8,2,125,151,31,346
GUJARAT,2005,Male,41,9,10,293,320,84,757
GUJARAT,2005,Total,70,17,12,418,471,115,1103
GUJARAT,2006,Female,34,4,3,150,146,29,366
GUJARAT,2006,Male,46,13,10,347,365,67,848
GUJARAT,2006,Total,80,17,13,497,511,96,1214
GUJARAT,2007,Female,33,5,5,117,126,28,314
GUJARAT,2007,Male,38,10,13,289,451,99,900
GUJARAT,2007,Total,71,15,18,406,577,127,1214
GUJARAT,2008,Female,24,3,2,137,145,29,340
GUJARAT,2008,Male,23,6,8,312,378,78,805
GUJARAT,2008,Total,47,9,10,449,523,107,1145
GUJARAT,2009,Female,34,6,2,120,129,34,325
GUJARAT,2009,Male,24,9,4,266,375,56,734
GUJARAT,2009,Total,58,15,6,386,504,90,1059
GUJARAT,2010,Female,19,4,0,131,93,21,268
GUJARAT,2010,Male,27,14,7,312,365,89,814
GUJARAT,2010,Total,46,18,7,443,458,110,1082
GUJARAT,2011,Female,31,1,3,144,106,33,318
GUJARAT,2011,Male,30,6,9,376,347,58,826
GUJARAT,2011,Total,61,7,12,520,453,91,1144
GUJARAT,2012,Female,37,1,2,123,122,21,306
GUJARAT,2012,Male,18,6,4,348,338,131,845
GUJARAT,2012,Total,55,7,6,471,460,152,1151
GUJARAT,2013,Female,43,8,4,148,126,47,376
GUJARAT,2013,Male,34,2,6,292,326,126,786
GUJARAT,2013,Total,77,10,10,440,452,173,1162
HARYANA,2001,Female,12,1,15,67,42,6,143
HARYANA,2001,Male,24,11,47,291,264,38,675
HARYANA,2001,Total,36,12,62,358,306,44,818
HARYANA,2002,Female,2,3,1,97,47,6,156
HARYANA,2002,Male,4,8,4,336,271,32,655
HARYANA,2002,Total,6,11,5,433,318,38,811
HARYANA,2003,Female,1,1,7,93,41,8,151
HARYANA,2003,Male,2,1,12,308,243,31,597
HARYANA,2003,Total,3,2,19,401,284,39,748
HARYANA,2004,Female,0,0,2,100,51,6,159
HARYANA,2004,Male,0,1,20,278,244,40,583
HARYANA,2004,Total,0,1,22,378,295,46,742
HARYANA,2005,Female,3,1,4,80,40,15,143
HARYANA,2005,Male,6,7,17,286,286,67,669
HARYANA,2005,Total,9,8,21,366,326,82,812
HARYANA,2006,Female,0,1,2,90,55,8,156
HARYANA,2006,Male,0,8,19,314,354,48,743
HARYANA,2006,Total,0,9,21,404,409,56,899
HARYANA,2007,Female,14,8,9,84,45,7,167
HARYANA,2007,Male,19,20,29,332,322,53,775
HARYANA,2007,Total,33,28,38,416,367,60,942
HARYANA,2008,Female,3,5,5,97,63,12,185
HARYANA,2008,Male,4,6,8,307,360,100,785
HARYANA,2008,Total,7,11,13,404,423,112,970
HARYANA,2009,Female,0,2,2,96,106,15,221
HARYANA,2009,Male,2,4,9,331,357,83,786
HARYANA,2009,Total,2,6,11,427,463,98,1007
HARYANA,2010,Female,2,4,6,99,88,14,213
HARYANA,2010,Male,4,6,8,367,381,65,831
HARYANA,2010,Total,6,10,14,466,469,79,1044
HARYANA,2011,Female,3,1,1,80,88,27,200
HARYANA,2011,Male,2,3,6,402,428,84,925
HARYANA,2011,Total,5,4,7,482,516,111,1125
HARYANA,2012,Female,10,2,6,90,75,15,198
HARYANA,2012,Male,7,5,17,330,388,78,825
HARYANA,2012,Total,17,7,23,420,463,93,1023
HARYANA,2013,Female,13,6,11,95,73,15,213
HARYANA,2013,Male,14,9,34,357,309,72,795
HARYANA,2013,Total,27,15,45,452,382,87,1008
HIMACHAL PRADESH,2001,Female,1,1,1,11,19,6,39
HIMACHAL PRADESH,2001,Male,3,0,1,29,42,8,83
HIMACHAL PRADESH,2001,Total,4,1,2,40,61,14,122
HIMACHAL PRADESH,2002,Female,2,0,2,19,10,1,34
HIMACHAL PRADESH,2002,Male,3,1,2,36,43,13,98
HIMACHAL PRADESH,2002,Total,5,1,4,55,53,14,132
HIMACHAL PRADESH,2003,Female,0,0,1,12,16,5,34
HIMACHAL PRADESH,2003,Male,5,2,1,31,53,4,96
HIMACHAL PRADESH,2003,Total,5,2,2,43,69,9,130
HIMACHAL PRADESH,2004,Female,1,0,3,7,10,4,25
HIMACHAL PRADESH,2004,Male,2,3,0,30,34,16,85
HIMACHAL PRADESH,2004,Total,3,3,3,37,44,20,110
HIMACHAL PRADESH,2005,Female,3,0,3,13,16,1,36
HIMACHAL PRADESH,2005,Male,3,0,1,27,37,14,82
HIMACHAL PRADESH,2005,Total,6,0,4,40,53,15,118
HIMACHAL PRADESH,2006,Female,1,1,0,11,13,5,31
HIMACHAL PRADESH,2006,Male,3,0,0,37,51,7,98
HIMACHAL PRADESH,2006,Total,4,1,0,48,64,12,129
HIMACHAL PRADESH,2007,Female,2,1,1,15,14,2,35
HIMACHAL PRADESH,2007,Male,3,2,1,31,46,14,97
HIMACHAL PRADESH,2007,Total,5,3,2,46,60,16,132
HIMACHAL PRADESH,2008,Female,1,2,3,10,16,4,36
HIMACHAL PRADESH,2008,Male,3,1,4,27,49,10,94
HIMACHAL PRADESH,2008,Total,4,3,7,37,65,14,130
HIMACHAL PRADESH,2009,Female,4,1,1,10,14,9,39
HIMACHAL PRADESH,2009,Male,0,1,2,31,46,14,94
HIMACHAL PRADESH,2009,Total,4,2,3,41,60,23,133
HIMACHAL PRADESH,2010,Female,3,0,0,11,12,2,28
HIMACHAL PRADESH,2010,Male,2,0,3,31,52,17,105
HIMACHAL PRADESH,2010,Total,5,0,3,42,64,19,133
HIMACHAL PRADESH,2011,Female,3,1,2,12,7,7,32
HIMACHAL PRADESH,2011,Male,2,1,0,30,55,15,103
HIMACHAL PRADESH,2011,Total,5,2,2,42,62,22,135
HIMACHAL PRADESH,2012,Female,2,2,0,14,8,1,27
HIMACHAL PRADESH,2012,Male,2,3,4,31,38,8,86
HIMACHAL PRADESH,2012,Total,4,5,4,45,46,9,113
HIMACHAL PRADESH,2013,Female,3,0,0,13,6,7,29
HIMACHAL PRADESH,2013,Male,3,2,0,24,39,9,77
HIMACHAL PRADESH,2013,Total,6,2,0,37,45,16,106
JAMMU & KASHMIR,2001,Female,2,13,27,68,53,24,187
JAMMU & KASHMIR,2001,Male,8,37,160,385,468,167,1225
JAMMU & KASHMIR,2001,Total,10,50,187,453,521,191,1412
JAMMU & KASHMIR,2002,Female,0,0,0,71,85,7,163
JAMMU & KASHMIR,2002,Male,0,0,2,493,562,87,1144
JAMMU & KASHMIR,2002,Total,0,0,2,564,647,94,1307
JAMMU & KASHMIR,2003,Female,0,0,0,57,42,3,102
JAMMU & KASHMIR,2003,Male,0,0,0,375,559,79,1013
JAMMU & KASHMIR,2003,Total,0,0,0,432,601,82,1115
JAMMU & KASHMIR,2004,Female,1,0,0,58,36,12,107
JAMMU & KASHMIR,2004,Male,0,0,0,438,374,70,882
JAMMU & KASHMIR,2004,Total,1,0,0,496,410,82,989
JAMMU & KASHMIR,2005,Female,2,0,0,64,36,0,102
JAMMU & KASHMIR,2005,Male,2,0,0,361,236,45,644
JAMMU & KASHMIR,2005,Total,4,0,0,425,272,45,746
JAMMU & KASHMIR,2006,Female,0,1,5,37,32,1,76
JAMMU & KASHMIR,2006,Male,2,0,2,287,258,16,565
JAMMU & KASHMIR,2006,Total,2,1,7,324,290,17,641
JAMMU & KASHMIR,2007,Female,0,0,0,26,12,2,40
JAMMU & KASHMIR,2007,Male,0,0,0,170,140,16,326
JAMMU & KASHMIR,2007,Total,0,0,0,196,152,18,366
JAMMU & KASHMIR,2008,Female,0,0,0,13,15,2,30
JAMMU & KASHMIR,2008,Male,0,0,0,94,126,16,236
JAMMU & KASHMIR,2008,Total,0,0,0,107,141,18,266
JAMMU & KASHMIR,2009,Female,0,0,0,26,16,4,46
JAMMU & KASHMIR,2009,Male,1,0,3,98,104,10,216
JAMMU & KASHMIR,2009,Total,1,0,3,124,120,14,262
JAMMU & KASHMIR,2010,Female,1,0,0,15,11,3,30
JAMMU & KASHMIR,2010,Male,0,0,0,91,95,19,205
JAMMU & KASHMIR,2010,Total,1,0,0,106,106,22,235
JAMMU & KASHMIR,2011,Female,1,1,0,19,9,3,33
JAMMU & KASHMIR,2011,Male,2,0,7,44,76,18,147
JAMMU & KASHMIR,2011,Total,3,1,7,63,85,21,180
JAMMU & KASHMIR,2012,Female,1,0,0,12,13,1,27
JAMMU & KASHMIR,2012,Male,2,0,0,32,66,5,105
JAMMU & KASHMIR,2012,Total,3,0,0,44,79,6,132
JAMMU & KASHMIR,2013,Female,4,1,0,14,7,2,28
JAMMU & KASHMIR,2013,Male,6,2,0,47,90,11,156
JAMMU & KASHMIR,2013,Total,10,3,0,61,97,13,184
JHARKHAND,2001,Female,0,0,39,126,102,24,291
JHARKHAND,2001,Male,4,3,121,470,482,136,1216
JHARKHAND,2001,Total,4,3,160,596,584,160,1507
JHARKHAND,2002,Female,1,1,1,140,107,56,306
JHARKHAND,2002,Male,2,1,2,495,444,238,1182
JHARKHAND,2002,Total,3,2,3,635,551,294,1488
JHARKHAND,2003,Female,2,1,1,177,185,30,396
JHARKHAND,2003,Male,5,2,1,506,487,85,1086
JHARKHAND,2003,Total,7,3,2,683,672,115,1482
JHARKHAND,2004,Female,2,1,1,179,186,30,399
JHARKHAND,2004,Male,5,2,1,507,489,85,1089
JHARKHAND,2004,Total,7,3,2,686,675,115,1488
JHARKHAND,2005,Female,0,6,44,62,45,16,173
JHARKHAND,2005,Male,5,23,69,390,749,114,1350
JHARKHAND,2005,Total,5,29,113,452,794,130,1523
JHARKHAND,2006,Female,1,1,38,83,58,33,214
JHARKHAND,2006,Male,11,17,71,474,480,225,1278
JHARKHAND,2006,Total,12,18,109,557,538,258,1492
JHARKHAND,2007,Female,2,1,5,87,115,27,237
JHARKHAND,2007,Male,0,12,5,550,711,102,1380
JHARKHAND,2007,Total,2,13,10,637,826,129,1617
JHARKHAND,2008,Female,2,0,1,115,123,25,266
JHARKHAND,2008,Male,2,0,6,726,624,73,1431
JHARKHAND,2008,Total,4,0,7,841,747,98,1697
JHARKHAND,2009,Female,1,1,0,119,72,8,201
JHARKHAND,2009,Male,3,1,5,609,736,81,1435
JHARKHAND,2009,Total,4,2,5,728,808,89,1636
JHARKHAND,2010,Female,0,0,1,141,102,12,256
JHARKHAND,2010,Male,4,2,1,895,529,65,1496
JHARKHAND,2010,Total,4,2,2,1036,631,77,1752
JHARKHAND,2011,Female,0,0,3,140,99,13,255
JHARKHAND,2011,Male,0,1,28,917,521,79,1546
JHARKHAND,2011,Total,0,1,31,1057,620,92,1801
JHARKHAND,2012,Female,1,0,7,123,89,7,227
JHARKHAND,2012,Male,0,4,47,767,626,71,1515
JHARKHAND,2012,Total,1,4,54,890,715,78,1742
JHARKHAND,2013,Female,0,0,12,128,82,10,232
JHARKHAND,2013,Male,1,0,40,782,556,52,1431
JHARKHAND,2013,Total,1,0,52,910,638,62,1663
KARNATAKA,2001,Female,38,13,24,250,201,51,577
KARNATAKA,2001,Male,42,9,36,450,434,130,1101
KARNATAKA,2001,Total,80,22,60,700,635,181,1678
KARNATAKA,2002,Female,7,0,3,346,214,25,595
KARNATAKA,2002,Male,11,3,4,480,480,131,1109
KARNATAKA,2002,Total,18,3,7,826,694,156,1704
KARNATAKA,2003,Female,50,12,21,249,154,39,525
KARNATAKA,2003,Male,41,11,50,399,439,111,1051
KARNATAKA,2003,Total,91,23,71,648,593,150,1576
KARNATAKA,2004,Female,23,0,2,313,172,51,561
KARNATAKA,2004,Male,24,3,2,432,433,112,1006
KARNATAKA,2004,Total,47,3,4,745,605,163,1567
KARNATAKA,2005,Female,17,2,3,306,206,51,585
KARNATAKA,2005,Male,22,0,3,473,459,131,1088
KARNATAKA,2005,Total,39,2,6,779,665,182,1673
KARNATAKA,2006,Female,30,3,2,294,195,64,588
KARNATAKA,2006,Male,28,10,6,463,482,100,1089
KARNATAKA,2006,Total,58,13,8,757,677,164,1677
KARNATAKA,2007,Female,17,4,6,289,148,41,505
KARNATAKA,2007,Male,15,5,6,381,541,133,1081
KARNATAKA,2007,Total,32,9,12,670,689,174,1586
KARNATAKA,2008,Female,49,17,14,272,229,43,624
KARNATAKA,2008,Male,58,11,18,428,532,129,1176
KARNATAKA,2008,Total,107,28,32,700,761,172,1800
KARNATAKA,2009,Female,16,9,7,335,246,66,679
KARNATAKA,2009,Male,12,14,5,363,558,121,1073
KARNATAKA,2009,Total,28,23,12,698,804,187,1752
KARNATAKA,2010,Female,27,3,5,377,262,57,731
KARNATAKA,2010,Male,18,3,4,481,511,130,1147
KARNATAKA,2010,Total,45,6,9,858,773,187,1878
KARNATAKA,2011,Female,41,4,14,345,283,76,763
KARNATAKA,2011,Male,32,2,21,445,504,153,1157
KARNATAKA,2011,Total,73,6,35,790,787,229,1920
KARNATAKA,2012,Female,42,7,20,315,318,62,764
KARNATAKA,2012,Male,33,13,20,403,534,153,1156
KARNATAKA,2012,Total,75,20,40,718,852,215,1920
KARNATAKA,2013,Female,54,8,17,340,246,51,716
KARNATAKA,2013,Male,27,9,27,402,413,90,968
KARNATAKA,2013,Total,81,17,44,742,659,141,1684
KERALA,2001,Female,36,5,8,25,58,24,156
KERALA,2001,Male,27,8,9,88,146,55,333
KERALA,2001,Total,63,13,17,113,204,79,489
KERALA,2002,Female,44,5,2,31,46,27,155
KERALA,2002,Male,20,4,5,87,133,50,299
KERALA,2002,Total,64,9,7,118,179,77,454
KERALA,2003,Female,15,3,3,28,55,22,126
KERALA,2003,Male,7,1,2,92,151,56,309
KERALA,2003,Total,22,4,5,120,206,78,435
KERALA,2004,Female,16,6,2,26,58,29,137
KERALA,2004,Male,24,2,3,68,131,62,290
KERALA,2004,Total,40,8,5,94,189,91,427
KERALA,2005,Female,36,7,0,25,49,30,147
KERALA,2005,Male,18,4,4,62,134,62,284
KERALA,2005,Total,54,11,4,87,183,92,431
KERALA,2006,Female,35,3,2,30,41,27,138
KERALA,2006,Male,30,1,1,72,133,51,288
KERALA,2006,Total,65,4,3,102,174,78,426
KERALA,2007,Female,22,1,4,34,52,28,141
KERALA,2007,Male,17,8,1,54,115,57,252
KERALA,2007,Total,39,9,5,88,167,85,393
KERALA,2008,Female,25,5,0,24,51,23,128
KERALA,2008,Male,14,5,0,62,116,54,251
KERALA,2008,Total,39,10,0,86,167,77,379
KERALA,2009,Female,17,4,5,20,45,18,109
KERALA,2009,Male,25,7,1,60,109,58,260
KERALA,2009,Total,42,11,6,80,154,76,369
KERALA,2010,Female,16,6,0,24,53,27,126
KERALA,2010,Male,23,3,1,60,137,55,279
KERALA,2010,Total,39,9,1,84,190,82,405
KERALA,2011,Female,25,3,3,22,51,33,137
KERALA,2011,Male,24,1,1,47,109,76,258
KERALA,2011,Total,49,4,4,69,160,109,395
KERALA,2012,Female,15,8,2,21,47,27,120
KERALA,2012,Male,14,5,2,61,127,60,269
KERALA,2012,Total,29,13,4,82,174,87,389
KERALA,2013,Female,25,3,0,18,45,30,121
KERALA,2013,Male,23,3,3,31,123,70,253
KERALA,2013,Total,48,6,3,49,168,100,374
LAKSHADWEEP,2001,Female,1,1,0,0,0,0,2
LAKSHADWEEP,2001,Male,0,0,0,0,0,0,0
LAKSHADWEEP,2001,Total,1,1,0,0,0,0,2
LAKSHADWEEP,2002,Female,0,0,0,0,0,0,0
LAKSHADWEEP,2002,Male,0,0,0,0,0,0,0
LAKSHADWEEP,2002,Total,0,0,0,0,0,0,0
LAKSHADWEEP,2003,Female,0,0,0,0,0,0,0
LAKSHADWEEP,2003,Male,0,0,0,0,0,0,0
LAKSHADWEEP,2003,Total,0,0,0,0,0,0,0
LAKSHADWEEP,2004,Female,0,0,0,0,0,0,0
LAKSHADWEEP,2004,Male,0,0,0,0,0,0,0
LAKSHADWEEP,2004,Total,0,0,0,0,0,0,0
LAKSHADWEEP,2005,Female,0,0,0,1,0,0,1
LAKSHADWEEP,2005,Male,0,0,0,0,0,0,0
LAKSHADWEEP,2005,Total,0,0,0,1,0,0,1
LAKSHADWEEP,2006,Female,0,0,0,0,0,0,0
LAKSHADWEEP,2006,Male,0,0,0,0,0,0,0
LAKSHADWEEP,2006,Total,0,0,0,0,0,0,0
LAKSHADWEEP,2007,Female,0,0,0,0,0,0,0
LAKSHADWEEP,2007,Male,0,0,0,0,0,0,0
LAKSHADWEEP,2007,Total,0,0,0,0,0,0,0
LAKSHADWEEP,2008,Female,0,0,0,0,1,0,1
LAKSHADWEEP,2008,Male,0,0,0,0,0,0,0
LAKSHADWEEP,2008,Total,0,0,0,0,1,0,1
LAKSHADWEEP,2009,Female,0,0,0,0,0,0,0
LAKSHADWEEP,2009,Male,0,0,0,0,0,0,0
LAKSHADWEEP,2009,Total,0,0,0,0,0,0,0
LAKSHADWEEP,2010,Female,0,0,0,0,0,0,0
LAKSHADWEEP,2010,Male,0,0,0,0,0,0,0
LAKSHADWEEP,2010,Total,0,0,0,0,0,0,0
LAKSHADWEEP,2011,Female,0,0,0,0,0,0,0
LAKSHADWEEP,2011,Male,0,0,0,0,0,0,0
LAKSHADWEEP,2011,Total,0,0,0,0,0,0,0
LAKSHADWEEP,2012,Female,0,0,0,0,0,0,0
LAKSHADWEEP,2012,Male,0,0,0,0,0,0,0
LAKSHADWEEP,2012,Total,0,0,0,0,0,0,0
LAKSHADWEEP,2013,Female,0,0,0,0,0,0,0
LAKSHADWEEP,2013,Male,0,0,0,0,0,0,0
LAKSHADWEEP,2013,Total,0,0,0,0,0,0,0
MADHYA PRADESH,2001,Female,41,13,37,281,219,31,622
MADHYA PRADESH,2001,Male,32,25,129,693,854,70,1803
MADHYA PRADESH,2001,Total,73,38,166,974,1073,101,2425
MADHYA PRADESH,2002,Female,2,5,7,258,194,71,537
MADHYA PRADESH,2002,Male,6,7,67,891,743,144,1858
MADHYA PRADESH,2002,Total,8,12,74,1149,937,215,2395
MADHYA PRADESH,2003,Female,16,4,39,194,151,50,454
MADHYA PRADESH,2003,Male,25,21,60,790,773,104,1773
MADHYA PRADESH,2003,Total,41,25,99,984,924,154,2227
MADHYA PRADESH,2004,Female,1,4,18,262,158,51,494
MADHYA PRADESH,2004,Male,7,18,96,826,715,224,1886
MADHYA PRADESH,2004,Total,8,22,114,1088,873,275,2380
MADHYA PRADESH,2005,Female,10,15,20,248,179,56,528
MADHYA PRADESH,2005,Male,25,20,60,771,795,229,1900
MADHYA PRADESH,2005,Total,35,35,80,1019,974,285,2428
MADHYA PRADESH,2006,Female,14,14,22,200,186,74,510
MADHYA PRADESH,2006,Male,34,22,54,700,722,288,1820
MADHYA PRADESH,2006,Total,48,36,76,900,908,362,2330
MADHYA PRADESH,2007,Female,33,7,11,253,183,64,551
MADHYA PRADESH,2007,Male,48,27,34,697,741,217,1764
MADHYA PRADESH,2007,Total,81,34,45,950,924,281,2315
MADHYA PRADESH,2008,Female,11,13,6,235,187,64,516
MADHYA PRADESH,2008,Male,11,55,11,695,815,248,1835
MADHYA PRADESH,2008,Total,22,68,17,930,1002,312,2351
MADHYA PRADESH,2009,Female,18,11,11,277,231,77,625
MADHYA PRADESH,2009,Male,42,20,25,672,761,257,1777
MADHYA PRADESH,2009,Total,60,31,36,949,992,334,2402
MADHYA PRADESH,2010,Female,21,13,9,246,202,60,551
MADHYA PRADESH,2010,Male,34,27,40,732,813,244,1890
MADHYA PRADESH,2010,Total,55,40,49,978,1015,304,2441
MADHYA PRADESH,2011,Female,21,8,8,286,262,94,679
MADHYA PRADESH,2011,Male,30,24,36,753,770,263,1876
MADHYA PRADESH,2011,Total,51,32,44,1039,1032,357,2555
MADHYA PRADESH,2012,Female,32,8,16,288,238,71,653
MADHYA PRADESH,2012,Male,35,22,33,719,723,246,1778
MADHYA PRADESH,2012,Total,67,30,49,1007,961,317,2431
MADHYA PRADESH,2013,Female,18,13,8,293,241,60,633
MADHYA PRADESH,2013,Male,31,20,37,596,647,194,1525
MADHYA PRADESH,2013,Total,49,33,45,889,888,254,2158
MAHARASHTRA,2001,Female,76,28,41,555,290,78,1068
MAHARASHTRA,2001,Male,113,28,39,740,743,219,1882
MAHARASHTRA,2001,Total,189,56,80,1295,1033,297,2950
MAHARASHTRA,2002,Female,75,27,18,475,293,78,966
MAHARASHTRA,2002,Male,81,27,27,716,899,275,2025
MAHARASHTRA,2002,Total,156,54,45,1191,1192,353,2991
MAHARASHTRA,2003,Female,79,22,18,533,274,70,996
MAHARASHTRA,2003,Male,63,22,23,717,826,304,1955
MAHARASHTRA,2003,Total,142,44,41,1250,1100,374,2951
MAHARASHTRA,2004,Female,69,10,16,523,299,87,1004
MAHARASHTRA,2004,Male,56,18,36,653,806,204,1773
MAHARASHTRA,2004,Total,125,28,52,1176,1105,291,2777
MAHARASHTRA,2005,Female,77,17,19,488,312,67,980
MAHARASHTRA,2005,Male,77,26,26,634,777,225,1765
MAHARASHTRA,2005,Total,154,43,45,1122,1089,292,2745
MAHARASHTRA,2006,Female,75,14,27,482,321,76,995
MAHARASHTRA,2006,Male,84,24,27,726,814,291,1966
MAHARASHTRA,2006,Total,159,38,54,1208,1135,367,2961
MAHARASHTRA,2007,Female,73,15,19,521,297,89,1014
MAHARASHTRA,2007,Male,92,24,27,654,723,259,1779
MAHARASHTRA,2007,Total,165,39,46,1175,1020,348,2793
MAHARASHTRA,2008,Female,62,11,21,541,341,73,1049
MAHARASHTRA,2008,Male,54,32,20,700,859,262,1927
MAHARASHTRA,2008,Total,116,43,41,1241,1200,335,2976
MAHARASHTRA,2009,Female,79,15,18,490,294,104,1000
MAHARASHTRA,2009,Male,63,11,20,681,721,216,1712
MAHARASHTRA,2009,Total,142,26,38,1171,1015,320,2712
MAHARASHTRA,2010,Female,78,16,14,552,303,84,1047
MAHARASHTRA,2010,Male,91,18,20,670,753,238,1790
MAHARASHTRA,2010,Total,169,34,34,1222,1056,322,2837
MAHARASHTRA,2011,Female,63,18,21,538,292,102,1034
MAHARASHTRA,2011,Male,78,16,30,685,826,252,1887
MAHARASHTRA,2011,Total,141,34,51,1223,1118,354,2921
MAHARASHTRA,2012,Female,92,17,13,493,311,87,1013
MAHARASHTRA,2012,Male,67,22,27,653,792,248,1809
MAHARASHTRA,2012,Total,159,39,40,1146,1103,335,2822
MAHARASHTRA,2013,Female,76,23,17,412,287,80,895
MAHARASHTRA,2013,Male,67,19,23,626,673,282,1690
MAHARASHTRA,2013,Total,143,42,40,1038,960,362,2585
MANIPUR,2001,Female,2,0,0,2,3,1,8
MANIPUR,2001,Male,0,0,8,137,70,10,225
MANIPUR,2001,Total,2,0,8,139,73,11,233
MANIPUR,2002,Female,0,0,0,7,6,1,14
MANIPUR,2002,Male,0,0,0,123,80,5,208
MANIPUR,2002,Total,0,0,0,130,86,6,222
MANIPUR,2003,Female,1,0,0,8,2,0,11
MANIPUR,2003,Male,0,0,0,109,56,9,174
MANIPUR,2003,Total,1,0,0,117,58,9,185
MANIPUR,2004,Female,0,0,0,8,6,1,15
MANIPUR,2004,Male,0,0,0,117,52,9,178
MANIPUR,2004,Total,0,0,0,125,58,10,193
MANIPUR,2005,Female,1,1,1,12,4,0,19
MANIPUR,2005,Male,0,0,0,174,96,6,276
MANIPUR,2005,Total,1,1,1,186,100,6,295
MANIPUR,2006,Female,0,0,1,5,2,1,9
MANIPUR,2006,Male,0,2,4,122,85,16,229
MANIPUR,2006,Total,0,2,5,127,87,17,238
MANIPUR,2007,Female,0,0,2,8,8,2,20
MANIPUR,2007,Male,1,1,4,140,121,8,275
MANIPUR,2007,Total,1,1,6,148,129,10,295
MANIPUR,2008,Female,2,0,0,9,8,0,19
MANIPUR,2008,Male,3,4,3,132,95,12,249
MANIPUR,2008,Total,5,4,3,141,103,12,268
MANIPUR,2009,Female,2,1,1,5,7,2,18
MANIPUR,2009,Male,2,1,3,56,78,16,156
MANIPUR,2009,Total,4,2,4,61,85,18,174
MANIPUR,2010,Female,0,0,0,5,13,1,19
MANIPUR,2010,Male,0,2,0,26,46,8,82
MANIPUR,2010,Total,0,2,0,31,59,9,101
MANIPUR,2011,Female,1,1,0,5,5,1,13
MANIPUR,2011,Male,1,2,1,30,45,6,85
MANIPUR,2011,Total,2,3,1,35,50,7,98
MANIPUR,2012,Female,1,1,2,2,9,1,16
MANIPUR,2012,Male,1,0,1,16,56,11,85
MANIPUR,2012,Total,2,1,3,18,65,12,101
MANIPUR,2013,Female,0,0,0,8,9,1,18
MANIPUR,2013,Male,0,1,3,21,42,14,81
MANIPUR,2013,Total,0,1,3,29,51,15,99
MEGHALAYA,2001,Female,0,0,0,4,2,0,6
MEGHALAYA,2001,Male,0,0,0,112,50,1,163
MEGHALAYA,2001,Total,0,0,0,116,52,1,169
MEGHALAYA,2002,Female,1,0,0,3,20,1,25
MEGHALAYA,2002,Male,0,0,2,76,78,3,159
MEGHALAYA,2002,Total,1,0,2,79,98,4,184
MEGHALAYA,2003,Female,0,0,2,4,3,1,10
MEGHALAYA,2003,Male,1,0,11,60,90,3,165
MEGHALAYA,2003,Total,1,0,13,64,93,4,175
MEGHALAYA,2004,Female,0,0,1,6,1,0,8
MEGHALAYA,2004,Male,0,0,0,97,51,1,149
MEGHALAYA,2004,Total,0,0,1,103,52,1,157
MEGHALAYA,2005,Female,1,0,4,8,4,2,19
MEGHALAYA,2005,Male,2,1,3,49,60,4,119
MEGHALAYA,2005,Total,3,1,7,57,64,6,138
MEGHALAYA,2006,Female,1,0,0,7,3,0,11
MEGHALAYA,2006,Male,1,0,5,75,62,3,146
MEGHALAYA,2006,Total,2,0,5,82,65,3,157
MEGHALAYA,2007,Female,2,0,0,3,2,0,7
MEGHALAYA,2007,Male,0,3,7,36,52,9,107
MEGHALAYA,2007,Total,2,3,7,39,54,9,114
MEGHALAYA,2008,Female,0,0,0,11,4,0,15
MEGHALAYA,2008,Male,0,0,0,54,48,9,111
MEGHALAYA,2008,Total,0,0,0,65,52,9,126
MEGHALAYA,2009,Female,0,0,3,16,2,1,22
MEGHALAYA,2009,Male,0,2,3,69,25,7,106
MEGHALAYA,2009,Total,0,2,6,85,27,8,128
MEGHALAYA,2010,Female,1,0,0,5,3,2,11
MEGHALAYA,2010,Male,0,0,1,64,53,8,126
MEGHALAYA,2010,Total,1,0,1,69,56,10,137
MEGHALAYA,2011,Female,0,0,0,5,6,1,12
MEGHALAYA,2011,Male,1,4,3,61,77,12,158
MEGHALAYA,2011,Total,1,4,3,66,83,13,170
MEGHALAYA,2012,Female,0,0,0,3,0,1,4
MEGHALAYA,2012,Male,0,0,0,80,45,13,138
MEGHALAYA,2012,Total,0,0,0,83,45,14,142
MEGHALAYA,2013,Female,2,1,0,7,8,1,19
MEGHALAYA,2013,Male,1,1,4,64,67,11,148
MEGHALAYA,2013,Total,3,2,4,71,75,12,167
MIZORAM,2001,Female,0,0,0,9,3,0,12
MIZORAM,2001,Male,0,0,3,8,6,2,19
MIZORAM,2001,Total,0,0,3,17,9,2,31
MIZORAM,2002,Female,0,0,0,8,1,0,9
MIZORAM,2002,Male,0,0,0,15,3,2,20
MIZORAM,2002,Total,0,0,0,23,4,2,29
MIZORAM,2003,Female,0,0,0,5,4,0,9
MIZORAM,2003,Male,1,0,4,11,20,1,37
MIZORAM,2003,Total,1,0,4,16,24,1,46
MIZORAM,2004,Female,0,0,0,2,1,1,4
MIZORAM,2004,Male,0,0,0,13,13,5,31
MIZORAM,2004,Total,0,0,0,15,14,6,35
MIZORAM,2005,Female,0,0,0,2,1,1,4
MIZORAM,2005,Male,0,0,0,13,13,5,31
MIZORAM,2005,Total,0,0,0,15,14,6,35
MIZORAM,2006,Female,0,0,0,3,0,0,3
MIZORAM,2006,Male,0,0,0,17,5,0,22
MIZORAM,2006,Total,0,0,0,20,5,0,25
MIZORAM,2007,Female,0,1,1,11,5,0,18
MIZORAM,2007,Male,0,0,1,15,7,2,25
MIZORAM,2007,Total,0,1,2,26,12,2,43
MIZORAM,2008,Female,0,0,0,1,1,0,2
MIZORAM,2008,Male,0,0,0,23,10,0,33
MIZORAM,2008,Total,0,0,0,24,11,0,35
MIZORAM,2009,Female,0,0,0,3,0,0,3
MIZORAM,2009,Male,0,0,0,8,20,0,28
MIZORAM,2009,Total,0,0,0,11,20,0,31
MIZORAM,2010,Female,0,0,1,0,6,1,8
MIZORAM,2010,Male,0,0,1,8,23,8,40
MIZORAM,2010,Total,0,0,2,8,29,9,48
MIZORAM,2011,Female,0,0,0,1,7,1,9
MIZORAM,2011,Male,0,1,0,2,12,2,17
MIZORAM,2011,Total,0,1,0,3,19,3,26
MIZORAM,2012,Female,1,0,0,0,1,1,3
MIZORAM,2012,Male,0,0,0,9,14,4,27
MIZORAM,2012,Total,1,0,0,9,15,5,30
MIZORAM,2013,Female,1,0,0,2,3,3,9
MIZORAM,2013,Male,0,2,0,9,7,2,20
MIZORAM,2013,Total,1,2,0,11,10,5,29
NAGALAND,2001,Female,0,0,2,0,0,0,2
NAGALAND,2001,Male,0,1,3,64,36,3,107
NAGALAND,2001,Total,0,1,5,64,36,3,109
NAGALAND,2002,Female,0,0,0,1,2,0,3
NAGALAND,2002,Male,0,2,7,71,24,1,105
NAGALAND,2002,Total,0,2,7,72,26,1,108
NAGALAND,2003,Female,0,0,0,5,1,0,6
NAGALAND,2003,Male,0,0,0,65,20,0,85
NAGALAND,2003,Total,0,0,0,70,21,0,91
NAGALAND,2004,Female,0,0,0,8,9,0,17
NAGALAND,2004,Male,0,0,0,28,28,0,56
NAGALAND,2004,Total,0,0,0,36,37,0,73
NAGALAND,2005,Female,0,0,0,13,2,2,17
NAGALAND,2005,Male,0,0,0,35,36,3,74
NAGALAND,2005,Total,0,0,0,48,38,5,91
NAGALAND,2006,Female,0,0,0,3,3,2,8
NAGALAND,2006,Male,4,1,4,74,32,0,115
NAGALAND,2006,Total,4,1,4,77,35,2,123
NAGALAND,2007,Female,1,0,1,9,3,0,14
NAGALAND,2007,Male,0,0,1,42,58,3,104
NAGALAND,2007,Total,1,0,2,51,61,3,118
NAGALAND,2008,Female,0,0,0,5,1,0,6
NAGALAND,2008,Male,0,0,0,81,57,3,141
NAGALAND,2008,Total,0,0,0,86,58,3,147
NAGALAND,2009,Female,0,0,0,9,0,0,9
NAGALAND,2009,Male,0,0,0,21,18,1,40
NAGALAND,2009,Total,0,0,0,30,18,1,49
NAGALAND,2010,Female,0,0,0,1,1,3,5
NAGALAND,2010,Male,0,0,0,19,16,7,42
NAGALAND,2010,Total,0,0,0,20,17,10,47
NAGALAND,2011,Female,0,1,1,2,2,0,6
NAGALAND,2011,Male,0,0,3,9,21,8,41
NAGALAND,2011,Total,0,1,4,11,23,8,47
NAGALAND,2012,Female,1,0,1,1,1,0,4
NAGALAND,2012,Male,0,1,2,43,28,5,79
NAGALAND,2012,Total,1,1,3,44,29,5,83
NAGALAND,2013,Female,0,0,0,5,1,1,7
NAGALAND,2013,Male,0,0,0,48,22,3,73
NAGALAND,2013,Total,0,0,0,53,23,4,80
ODISHA,2001,Female,0,0,13,140,81,26,260
ODISHA,2001,Male,0,2,43,350,304,46,745
ODISHA,2001,Total,0,2,56,490,385,72,1005
ODISHA,2002,Female,3,0,0,201,117,25,346
ODISHA,2002,Male,2,2,0,378,372,48,802
ODISHA,2002,Total,5,2,0,579,489,73,1148
ODISHA,2003,Female,3,0,3,178,128,21,333
ODISHA,2003,Male,5,4,10,363,322,65,769
ODISHA,2003,Total,8,4,13,541,450,86,1102
ODISHA,2004,Female,1,3,0,221,114,18,357
ODISHA,2004,Male,1,1,3,389,341,45,780
ODISHA,2004,Total,2,4,3,610,455,63,1137
ODISHA,2005,Female,1,2,3,162,126,32,326
ODISHA,2005,Male,2,1,1,373,375,55,807
ODISHA,2005,Total,3,3,4,535,501,87,1133
ODISHA,2006,Female,3,0,2,192,175,12,384
ODISHA,2006,Male,0,4,9,368,360,42,783
ODISHA,2006,Total,3,4,11,560,535,54,1167
ODISHA,2007,Female,2,2,4,242,116,6,372
ODISHA,2007,Male,4,10,11,395,405,38,863
ODISHA,2007,Total,6,12,15,637,521,44,1235
ODISHA,2008,Female,2,2,0,257,237,47,545
ODISHA,2008,Male,4,2,3,276,369,51,705
ODISHA,2008,Total,6,4,3,533,606,98,1250
ODISHA,2009,Female,3,1,0,215,201,40,460
ODISHA,2009,Male,1,0,8,336,343,118,806
ODISHA,2009,Total,4,1,8,551,544,158,1266
ODISHA,2010,Female,5,0,1,262,236,32,536
ODISHA,2010,Male,5,0,1,304,401,72,783
ODISHA,2010,Total,10,0,2,566,637,104,1319
ODISHA,2011,Female,3,1,1,254,208,28,495
ODISHA,2011,Male,4,0,9,356,553,60,982
ODISHA,2011,Total,7,1,10,610,761,88,1477
ODISHA,2012,Female,7,5,8,344,235,32,631
ODISHA,2012,Male,4,4,7,400,463,87,965
ODISHA,2012,Total,11,9,15,744,698,119,1596
ODISHA,2013,Female,7,4,11,311,208,21,562
ODISHA,2013,Male,2,3,14,372,441,106,938
ODISHA,2013,Total,9,7,25,683,649,127,1500
PUDUCHERRY,2001,Female,0,0,1,5,4,0,10
PUDUCHERRY,2001,Male,0,0,0,5,7,3,15
PUDUCHERRY,2001,Total,0,0,1,10,11,3,25
PUDUCHERRY,2002,Female,1,0,0,1,8,1,11
PUDUCHERRY,2002,Male,1,0,0,6,12,1,20
PUDUCHERRY,2002,Total,2,0,0,7,20,2,31
PUDUCHERRY,2003,Female,0,1,0,3,2,2,8
PUDUCHERRY,2003,Male,1,0,0,8,10,3,22
PUDUCHERRY,2003,Total,1,1,0,11,12,5,30
PUDUCHERRY,2004,Female,0,0,0,1,2,0,3
PUDUCHERRY,2004,Male,1,0,0,11,8,2,22
PUDUCHERRY,2004,Total,1,0,0,12,10,2,25
PUDUCHERRY,2005,Female,0,0,0,5,1,3,9
PUDUCHERRY,2005,Male,0,0,0,3,7,0,10
PUDUCHERRY,2005,Total,0,0,0,8,8,3,19
PUDUCHERRY,2006,Female,0,0,0,3,5,1,9
PUDUCHERRY,2006,Male,0,0,1,9,9,2,21
PUDUCHERRY,2006,Total,0,0,1,12,14,3,30
PUDUCHERRY,2007,Female,1,0,0,4,3,2,10
PUDUCHERRY,2007,Male,1,0,1,17,5,1,25
PUDUCHERRY,2007,Total,2,0,1,21,8,3,35
PUDUCHERRY,2008,Female,0,0,0,5,1,2,8
PUDUCHERRY,2008,Male,1,0,0,12,11,3,27
PUDUCHERRY,2008,Total,1,0,0,17,12,5,35
PUDUCHERRY,2009,Female,1,0,0,3,5,1,10
PUDUCHERRY,2009,Male,0,0,0,13,14,2,29
PUDUCHERRY,2009,Total,1,0,0,16,19,3,39
PUDUCHERRY,2010,Female,0,0,0,3,1,0,4
PUDUCHERRY,2010,Male,0,0,0,10,12,8,30
PUDUCHERRY,2010,Total,0,0,0,13,13,8,34
PUDUCHERRY,2011,Female,0,0,0,2,1,0,3
PUDUCHERRY,2011,Male,0,0,0,10,14,7,31
PUDUCHERRY,2011,Total,0,0,0,12,15,7,34
PUDUCHERRY,2012,Female,0,0,0,2,4,2,8
PUDUCHERRY,2012,Male,0,0,0,5,13,4,22
PUDUCHERRY,2012,Total,0,0,0,7,17,6,30
PUDUCHERRY,2013,Female,0,0,0,1,2,4,7
PUDUCHERRY,2013,Male,0,0,0,6,13,5,24
PUDUCHERRY,2013,Total,0,0,0,7,15,9,31
PUNJAB,2001,Female,3,1,21,90,77,11,203
PUNJAB,2001,Male,7,9,35,268,222,43,584
PUNJAB,2001,Total,10,10,56,358,299,54,787
PUNJAB,2002,Female,1,2,2,74,57,5,141
PUNJAB,2002,Male,3,3,2,245,334,44,631
PUNJAB,2002,Total,4,5,4,319,391,49,772
PUNJAB,2003,Female,3,2,2,89,61,18,175
PUNJAB,2003,Male,9,3,6,249,271,56,594
PUNJAB,2003,Total,12,5,8,338,332,74,769
PUNJAB,2004,Female,13,4,2,84,74,17,194
PUNJAB,2004,Male,10,4,9,250,275,60,608
PUNJAB,2004,Total,23,8,11,334,349,77,802
PUNJAB,2005,Female,4,4,1,87,78,13,187
PUNJAB,2005,Male,7,5,5,244,241,55,557
PUNJAB,2005,Total,11,9,6,331,319,68,744
PUNJAB,2006,Female,3,5,4,120,81,24,237
PUNJAB,2006,Male,7,1,6,266,247,87,614
PUNJAB,2006,Total,10,6,10,386,328,111,851
PUNJAB,2007,Female,3,5,4,120,75,18,225
PUNJAB,2007,Male,7,8,6,266,247,67,601
PUNJAB,2007,Total,10,13,10,386,322,85,826
PUNJAB,2008,Female,3,5,7,120,67,17,219
PUNJAB,2008,Male,7,4,6,266,247,66,596
PUNJAB,2008,Total,10,9,13,386,314,83,815
PUNJAB,2009,Female,15,6,8,92,68,14,203
PUNJAB,2009,Male,18,15,20,251,312,42,658
PUNJAB,2009,Total,33,21,28,343,380,56,861
PUNJAB,2010,Female,11,6,6,107,91,21,242
PUNJAB,2010,Male,10,3,12,277,336,65,703
PUNJAB,2010,Total,21,9,18,384,427,86,945
PUNJAB,2011,Female,7,2,0,113,103,18,243
PUNJAB,2011,Male,14,10,8,269,266,56,623
PUNJAB,2011,Total,21,12,8,382,369,74,866
PUNJAB,2012,Female,8,3,4,90,109,30,244
PUNJAB,2012,Male,14,13,12,249,273,84,645
PUNJAB,2012,Total,22,16,16,339,382,114,889
PUNJAB,2013,Female,10,7,4,93,93,22,229
PUNJAB,2013,Male,10,4,8,185,237,65,509
PUNJAB,2013,Total,20,11,12,278,330,87,738
RAJASTHAN,2001,Female,8,4,15,108,81,32,248
RAJASTHAN,2001,Male,10,14,32,389,481,101,1027
RAJASTHAN,2001,Total,18,18,47,497,562,133,1275
RAJASTHAN,2002,Female,10,1,1,131,102,16,261
RAJASTHAN,2002,Male,5,1,2,432,531,92,1063
RAJASTHAN,2002,Total,15,2,3,563,633,108,1324
RAJASTHAN,2003,Female,2,3,3,123,106,34,271
RAJASTHAN,2003,Male,11,4,3,437,456,102,1013
RAJASTHAN,2003,Total,13,7,6,560,562,136,1284
RAJASTHAN,2004,Female,4,2,2,146,99,34,287
RAJASTHAN,2004,Male,4,4,5,422,443,127,1005
RAJASTHAN,2004,Total,8,6,7,568,542,161,1292
RAJASTHAN,2005,Female,14,4,9,124,116,29,296
RAJASTHAN,2005,Male,7,7,16,399,426,95,950
RAJASTHAN,2005,Total,21,11,25,523,542,124,1246
RAJASTHAN,2006,Female,11,6,6,113,83,30,249
RAJASTHAN,2006,Male,19,16,19,392,428,115,989
RAJASTHAN,2006,Total,30,22,25,505,511,145,1238
RAJASTHAN,2007,Female,10,12,6,143,123,25,319
RAJASTHAN,2007,Male,18,17,26,393,483,103,1040
RAJASTHAN,2007,Total,28,29,32,536,606,128,1359
RAJASTHAN,2008,Female,8,6,12,129,102,30,287
RAJASTHAN,2008,Male,13,18,36,398,467,101,1033
RAJASTHAN,2008,Total,21,24,48,527,569,131,1320
RAJASTHAN,2009,Female,13,8,8,150,114,35,328
RAJASTHAN,2009,Male,16,16,36,424,473,124,1089
RAJASTHAN,2009,Total,29,24,44,574,587,159,1417
RAJASTHAN,2010,Female,14,8,9,130,113,32,306
RAJASTHAN,2010,Male,15,14,33,437,513,103,1115
RAJASTHAN,2010,Total,29,22,42,567,626,135,1421
RAJASTHAN,2011,Female,13,6,10,140,119,44,332
RAJASTHAN,2011,Male,19,10,17,484,508,91,1129
RAJASTHAN,2011,Total,32,16,27,624,627,135,1461
RAJASTHAN,2012,Female,12,7,6,187,140,41,393
RAJASTHAN,2012,Male,12,5,13,445,486,107,1068
RAJASTHAN,2012,Total,24,12,19,632,626,148,1461
RAJASTHAN,2013,Female,7,9,4,178,158,40,396
RAJASTHAN,2013,Male,22,8,22,490,510,125,1177
RAJASTHAN,2013,Total,29,17,26,668,668,165,1573
SIKKIM,2001,Female,0,0,0,1,5,0,6
SIKKIM,2001,Male,1,0,0,7,3,2,13
SIKKIM,2001,Total,1,0,0,8,8,2,19
SIKKIM,2002,Female,0,0,0,0,0,0,0
SIKKIM,2002,Male,0,0,2,4,7,0,13
SIKKIM,2002,Total,0,0,2,4,7,0,13
SIKKIM,2003,Female,1,0,0,4,1,0,6
SIKKIM,2003,Male,0,0,1,5,2,2,10
SIKKIM,2003,Total,1,0,1,9,3,2,16
SIKKIM,2004,Female,2,0,0,2,0,1,5
SIKKIM,2004,Male,1,0,0,2,8,2,13
SIKKIM,2004,Total,3,0,0,4,8,3,18
SIKKIM,2005,Female,0,0,0,2,2,0,4
SIKKIM,2005,Male,0,1,0,1,2,1,5
SIKKIM,2005,Total,0,1,0,3,4,1,9
SIKKIM,2006,Female,0,0,0,3,3,1,7
SIKKIM,2006,Male,0,0,4,2,5,3,14
SIKKIM,2006,Total,0,0,4,5,8,4,21
SIKKIM,2007,Female,0,1,0,2,0,0,3
SIKKIM,2007,Male,0,0,0,3,2,1,6
SIKKIM,2007,Total,0,1,0,5,2,1,9
SIKKIM,2008,Female,0,0,0,3,0,0,3
SIKKIM,2008,Male,0,0,2,1,3,0,6
SIKKIM,2008,Total,0,0,2,4,3,0,9
SIKKIM,2009,Female,1,0,0,3,2,0,6
SIKKIM,2009,Male,2,0,0,7,4,1,14
SIKKIM,2009,Total,3,0,0,10,6,1,20
SIKKIM,2010,Female,1,1,0,3,3,0,8
SIKKIM,2010,Male,1,0,0,1,4,3,9
SIKKIM,2010,Total,2,1,0,4,7,3,17
SIKKIM,2011,Female,0,0,0,1,4,0,5
SIKKIM,2011,Male,0,0,0,2,5,2,9
SIKKIM,2011,Total,0,0,0,3,9,2,14
SIKKIM,2012,Female,0,1,2,0,1,0,4
SIKKIM,2012,Male,0,0,0,3,0,0,3
SIKKIM,2012,Total,0,1,2,3,1,0,7
SIKKIM,2013,Female,0,0,0,1,2,0,3
SIKKIM,2013,Male,0,0,0,8,3,1,12
SIKKIM,2013,Total,0,0,0,9,5,1,15
TAMIL NADU,2001,Female,5,8,113,174,191,34,525
TAMIL NADU,2001,Male,3,8,136,391,463,136,1137
TAMIL NADU,2001,Total,8,16,249,565,654,170,1662
TAMIL NADU,2002,Female,18,8,2,259,165,66,518
TAMIL NADU,2002,Male,11,4,2,512,543,197,1269
TAMIL NADU,2002,Total,29,12,4,771,708,263,1787
TAMIL NADU,2003,Female,7,7,25,239,182,83,543
TAMIL NADU,2003,Male,4,4,15,357,534,197,1111
TAMIL NADU,2003,Total,11,11,40,596,716,280,1654
TAMIL NADU,2004,Female,34,6,0,240,157,56,493
TAMIL NADU,2004,Male,32,7,4,372,447,189,1051
TAMIL NADU,2004,Total,66,13,4,612,604,245,1544
TAMIL NADU,2005,Female,32,7,0,199,159,65,462
TAMIL NADU,2005,Male,22,3,3,353,485,183,1049
TAMIL NADU,2005,Total,54,10,3,552,644,248,1511
TAMIL NADU,2006,Female,33,9,4,206,181,82,515
TAMIL NADU,2006,Male,15,7,2,286,439,154,903
TAMIL NADU,2006,Total,48,16,6,492,620,236,1418
TAMIL NADU,2007,Female,31,8,3,261,215,86,604
TAMIL NADU,2007,Male,18,6,2,346,507,228,1107
TAMIL NADU,2007,Total,49,14,5,607,722,314,1711
TAMIL NADU,2008,Female,45,3,4,233,246,93,624
TAMIL NADU,2008,Male,43,5,0,364,554,234,1200
TAMIL NADU,2008,Total,88,8,4,597,800,327,1824
TAMIL NADU,2009,Female,45,6,5,214,224,93,587
TAMIL NADU,2009,Male,36,8,5,364,611,246,1270
TAMIL NADU,2009,Total,81,14,10,578,835,339,1857
TAMIL NADU,2010,Female,38,5,9,236,241,100,629
TAMIL NADU,2010,Male,25,8,7,414,598,227,1279
TAMIL NADU,2010,Total,63,13,16,650,839,327,1908
TAMIL NADU,2011,Female,49,3,19,233,220,101,625
TAMIL NADU,2011,Male,41,9,15,440,610,200,1315
TAMIL NADU,2011,Total,90,12,34,673,830,301,1940
TAMIL NADU,2012,Female,33,11,11,198,243,126,622
TAMIL NADU,2012,Male,26,11,15,396,664,286,1398
TAMIL NADU,2012,Total,59,22,26,594,907,412,2020
TAMIL NADU,2013,Female,45,6,12,212,259,126,660
TAMIL NADU,2013,Male,26,6,10,361,661,316,1380
TAMIL NADU,2013,Total,71,12,22,573,920,442,2040
TRIPURA,2001,Female,0,0,2,3,2,2,9
TRIPURA,2001,Male,0,6,15,90,100,20,231
TRIPURA,2001,Total,0,6,17,93,102,22,240
TRIPURA,2002,Female,0,0,0,10,2,0,12
TRIPURA,2002,Male,0,0,0,95,72,22,189
TRIPURA,2002,Total,0,0,0,105,74,22,201
TRIPURA,2003,Female,0,0,0,18,5,0,23
TRIPURA,2003,Male,0,0,0,117,84,30,231
TRIPURA,2003,Total,0,0,0,135,89,30,254
TRIPURA,2004,Female,0,1,0,27,10,6,44
TRIPURA,2004,Male,0,2,2,97,65,16,182
TRIPURA,2004,Total,0,3,2,124,75,22,226
TRIPURA,2005,Female,1,0,0,49,10,4,64
TRIPURA,2005,Male,0,0,0,42,42,10,94
TRIPURA,2005,Total,1,0,0,91,52,14,158
TRIPURA,2006,Female,0,0,0,22,8,4,34
TRIPURA,2006,Male,1,2,0,49,65,14,131
TRIPURA,2006,Total,1,2,0,71,73,18,165
TRIPURA,2007,Female,3,0,2,19,18,8,50
TRIPURA,2007,Male,0,4,2,33,44,17,100
TRIPURA,2007,Total,3,4,4,52,62,25,150
TRIPURA,2008,Female,3,2,1,36,17,4,63
TRIPURA,2008,Male,4,7,3,21,55,13,103
TRIPURA,2008,Total,7,9,4,57,72,17,166
TRIPURA,2009,Female,4,3,3,22,21,4,57
TRIPURA,2009,Male,6,2,0,34,42,7,91
TRIPURA,2009,Total,10,5,3,56,63,11,148
TRIPURA,2010,Female,0,1,0,24,30,8,63
TRIPURA,2010,Male,0,1,0,36,43,16,96
TRIPURA,2010,Total,0,2,0,60,73,24,159
TRIPURA,2011,Female,1,0,0,47,15,1,64
TRIPURA,2011,Male,12,0,0,27,49,11,99
TRIPURA,2011,Total,13,0,0,74,64,12,163
TRIPURA,2012,Female,0,0,0,15,7,1,23
TRIPURA,2012,Male,2,0,0,32,53,14,101
TRIPURA,2012,Total,2,0,0,47,60,15,124
TRIPURA,2013,Female,3,1,1,23,21,7,56
TRIPURA,2013,Male,1,1,2,29,37,16,86
TRIPURA,2013,Total,4,2,3,52,58,23,142
UTTAR PRADESH,2001,Female,10,65,103,626,417,102,1323
UTTAR PRADESH,2001,Male,29,93,189,3098,2726,722,6857
UTTAR PRADESH,2001,Total,39,158,292,3724,3143,824,8180
UTTAR PRADESH,2002,Female,7,57,84,724,508,73,1453
UTTAR PRADESH,2002,Male,29,134,227,2824,2378,493,6085
UTTAR PRADESH,2002,Total,36,191,311,3548,2886,566,7538
UTTAR PRADESH,2003,Female,8,58,86,427,345,75,999
UTTAR PRADESH,2003,Male,27,87,206,2011,1542,412,4285
UTTAR PRADESH,2003,Total,35,145,292,2438,1887,487,5284
UTTAR PRADESH,2004,Female,56,71,124,613,451,86,1401
UTTAR PRADESH,2004,Male,60,147,223,2224,2146,464,5264
UTTAR PRADESH,2004,Total,116,218,347,2837,2597,550,6665
UTTAR PRADESH,2005,Female,19,59,63,695,447,71,1354
UTTAR PRADESH,2005,Male,25,65,159,2425,1854,483,5011
UTTAR PRADESH,2005,Total,44,124,222,3120,2301,554,6365
UTTAR PRADESH,2006,Female,11,63,82,408,306,57,927
UTTAR PRADESH,2006,Male,23,98,149,2405,1707,453,4835
UTTAR PRADESH,2006,Total,34,161,231,2813,2013,510,5762
UTTAR PRADESH,2007,Female,24,63,74,382,288,68,899
UTTAR PRADESH,2007,Male,37,97,102,2050,1619,378,4283
UTTAR PRADESH,2007,Total,61,160,176,2432,1907,446,5182
UTTAR PRADESH,2008,Female,30,55,73,360,257,65,840
UTTAR PRADESH,2008,Male,30,69,119,1927,1383,331,3859
UTTAR PRADESH,2008,Total,60,124,192,2287,1640,396,4699
UTTAR PRADESH,2009,Female,38,56,71,443,266,81,955
UTTAR PRADESH,2009,Male,33,89,85,1816,1347,354,3724
UTTAR PRADESH,2009,Total,71,145,156,2259,1613,435,4679
UTTAR PRADESH,2010,Female,62,30,47,421,243,56,859
UTTAR PRADESH,2010,Male,76,52,79,1937,1165,288,3597
UTTAR PRADESH,2010,Total,138,82,126,2358,1408,344,4456
UTTAR PRADESH,2011,Female,44,44,67,511,299,75,1040
UTTAR PRADESH,2011,Male,52,49,70,2149,1363,308,3991
UTTAR PRADESH,2011,Total,96,93,137,2660,1662,383,5031
UTTAR PRADESH,2012,Female,48,61,90,447,349,93,1088
UTTAR PRADESH,2012,Male,66,72,138,1762,1516,400,3954
UTTAR PRADESH,2012,Total,114,133,228,2209,1865,493,5042
UTTAR PRADESH,2013,Female,50,52,111,585,359,103,1260
UTTAR PRADESH,2013,Male,64,67,162,1658,1467,495,3913
UTTAR PRADESH,2013,Total,114,119,273,2243,1826,598,5173
UTTARAKHAND,2001,Female,2,2,1,72,29,4,110
UTTARAKHAND,2001,Male,2,3,3,52,184,27,271
UTTARAKHAND,2001,Total,4,5,4,124,213,31,381
UTTARAKHAND,2002,Female,0,2,2,23,37,3,67
UTTARAKHAND,2002,Male,0,2,1,77,169,19,268
UTTARAKHAND,2002,Total,0,4,3,100,206,22,335
UTTARAKHAND,2003,Female,0,0,2,28,30,2,62
UTTARAKHAND,2003,Male,0,0,1,87,127,16,231
UTTARAKHAND,2003,Total,0,0,3,115,157,18,293
UTTARAKHAND,2004,Female,2,0,0,22,18,5,47
UTTARAKHAND,2004,Male,2,0,0,108,90,20,220
UTTARAKHAND,2004,Total,4,0,0,130,108,25,267
UTTARAKHAND,2005,Female,2,0,0,25,25,1,53
UTTARAKHAND,2005,Male,2,2,0,102,103,28,237
UTTARAKHAND,2005,Total,4,2,0,127,128,29,290
UTTARAKHAND,2006,Female,2,0,1,17,33,2,55
UTTARAKHAND,2006,Male,0,2,5,79,134,10,230
UTTARAKHAND,2006,Total,2,2,6,96,167,12,285
UTTARAKHAND,2007,Female,2,3,0,53,12,7,77
UTTARAKHAND,2007,Male,3,1,5,111,53,18,191
UTTARAKHAND,2007,Total,5,4,5,164,65,25,268
UTTARAKHAND,2008,Female,0,0,0,29,16,3,48
UTTARAKHAND,2008,Male,1,0,2,139,46,25,213
UTTARAKHAND,2008,Total,1,0,2,168,62,28,261
UTTARAKHAND,2009,Female,1,1,0,38,10,1,51
UTTARAKHAND,2009,Male,1,1,1,72,56,13,144
UTTARAKHAND,2009,Total,2,2,1,110,66,14,195
UTTARAKHAND,2010,Female,0,0,2,25,11,6,44
UTTARAKHAND,2010,Male,0,1,0,66,52,13,132
UTTARAKHAND,2010,Total,0,1,2,91,63,19,176
UTTARAKHAND,2011,Female,0,0,0,32,12,1,45
UTTARAKHAND,2011,Male,2,4,3,63,55,19,146
UTTARAKHAND,2011,Total,2,4,3,95,67,20,191
UTTARAKHAND,2012,Female,2,1,1,52,12,8,76
UTTARAKHAND,2012,Male,1,0,6,68,43,23,141
UTTARAKHAND,2012,Total,3,1,7,120,55,31,217
UTTARAKHAND,2013,Female,2,0,1,39,21,11,74
UTTARAKHAND,2013,Male,2,1,1,41,62,16,123
UTTARAKHAND,2013,Total,4,1,2,80,83,27,197
WEST BENGAL,2001,Female,0,0,1,213,132,12,358
WEST BENGAL,2001,Male,1,2,2,676,552,82,1315
WEST BENGAL,2001,Total,1,2,3,889,684,94,1673
WEST BENGAL,2002,Female,3,0,0,188,72,9,272
WEST BENGAL,2002,Male,0,0,0,664,465,52,1181
WEST BENGAL,2002,Total,3,0,0,852,537,61,1453
WEST BENGAL,2003,Female,2,2,2,186,95,10,297
WEST BENGAL,2003,Male,1,0,2,606,506,52,1167
WEST BENGAL,2003,Total,3,2,4,792,601,62,1464
WEST BENGAL,2004,Female,1,1,0,218,191,14,425
WEST BENGAL,2004,Male,0,0,0,518,439,51,1008
WEST BENGAL,2004,Total,1,1,0,736,630,65,1433
WEST BENGAL,2005,Female,0,1,0,269,81,14,365
WEST BENGAL,2005,Male,0,1,0,673,355,60,1089
WEST BENGAL,2005,Total,0,2,0,942,436,74,1454
WEST BENGAL,2006,Female,0,0,0,335,95,17,447
WEST BENGAL,2006,Male,1,0,2,546,394,52,995
WEST BENGAL,2006,Total,1,0,2,881,489,69,1442
WEST BENGAL,2007,Female,7,0,3,441,175,21,647
WEST BENGAL,2007,Male,1,2,2,527,417,57,1006
WEST BENGAL,2007,Total,8,2,5,968,592,78,1653
WEST BENGAL,2008,Female,1,0,5,175,53,16,250
WEST BENGAL,2008,Male,1,5,9,735,662,149,1561
WEST BENGAL,2008,Total,2,5,14,910,715,165,1811
WEST BENGAL,2009,Female,2,5,4,409,248,25,693
WEST BENGAL,2009,Male,3,3,6,708,660,88,1468
WEST BENGAL,2009,Total,5,8,10,1117,908,113,2161
WEST BENGAL,2010,Female,2,3,2,542,308,36,893
WEST BENGAL,2010,Male,0,5,4,635,794,84,1522
WEST BENGAL,2010,Total,2,8,6,1177,1102,120,2415
WEST BENGAL,2011,Female,1,7,3,419,251,149,830
WEST BENGAL,2011,Male,6,4,25,703,650,49,1437
WEST BENGAL,2011,Total,7,11,28,1122,901,198,2267
WEST BENGAL,2012,Female,0,2,11,301,202,57,573
WEST BENGAL,2012,Male,1,9,23,861,522,263,1679
WEST BENGAL,2012,Total,1,11,34,1162,724,320,2252
WEST BENGAL,2013,Female,2,2,20,344,219,4,591
WEST BENGAL,2013,Male,1,11,34,1060,555,12,1673
WEST BENGAL,2013,Total,3,13,54,1404,774,16,2264
